1111111111111111111111111111111111111111
1000010000000000000000000000000001000001
1000010000000000000000000000000001000001
1000010111111111110001111111111101000001
1000010100000000000000000000000101000001
1000010100000000000000000000000101000001
1000010100111111111111111111100101000001
1000010100100000000000000000100101000001
1000010100100000000000000000100101000001
1000010100100111110001111100100101000001
1000010100100100000000000100100101000001
1000010100100100000000000100100101000001
1000010100100100110001100100100101000001
1000000100100100100000100100100100000001
1A000001000001000000000001000001000000B1
1000000100000100000O00000100000100000001
1000010100000100000000000100000101000001
1000010100100100100000100100100101000001
1000010100100100110001100100100101000001
1000010100100100000000000100100101000001
1000010100100100000000000100100101000001
1000010100100111110001111100100101000001
1000010100100000000000000000100101000001
1000010100100000000000000000100101000001
1000010100111111111111111111100101000001
1000010100000000000000000000000101000001
1000010100000000000000000000000101000001
1000010111111111110001111111111101000001
1000010000000000000000000000000001000001
1111111111111111111111111111111111111111
