1111111111111111111111111111111111111111
1A000000000000000000000000000000000000B1
1000000000000000000000000000000000000001
1000000000000000000000000000000000000001
1000000000000000000000000000000000000001
1000000000000000000000000000000000000001
1000000000000001000000100000000000000001
1000000000000010000000010000000000000001
1000000000000100000000001000000000000001
1000000000001000000000000100000000000001
1000000000010000000000000010000000000001
1000000000100000000000000001000000000001
1000000001000000000000000000100000000001
1000000010000000000000000000010000000001
1000000000000000000000000000000000000001
1000000000000000000000000000000000000001
1000000000000000000000000000000000000001
1000000010000000000000000000010000000001
1000000001000000000000000000100000000001
1000000000100000000000000001000000000001
1000000000010000000000000010000000000001
1000000000001000000000000100000000000001
1000000000000100000000001000000000000001
1000000000000010000000010000000000000001
1000000000000001000000100000000000000001
1000000000000010000000010000000000000001
1000000000000100000000001000000000000001
1011110011111100000000001111100111111101
100000000000000000O000000000000000000001
1111111111111111111111111111111111111111
