1111111111111111111111111111111111111111
10A0100000000000000000000000000000000001
1000100000000000000000000000000000000001
1000100111111111111111111111111110011001
1000100000000000000000000000000000010001
1000100000000000000000000000000000010011
1100100111111111111111111111000110010001
1000100100000000001000000001000010011001
1001100000000000001000000001000010010001
1000100000110010111000000000000010010011
1000100111100010111000111001001010010001
1100100100000010100000001001001010010001
1000100100100010100000001001001010010001
1000100100100000000000101001111010010001
10011000000000000000O0101000110010010001
1000100111111100000000101000110010010001
1000100000000111100111001000000011010001
1000100000000000100000001000000010010001
1000100111100000111111111000111110010001
1000100000100000000000000010001100010001
1000100000100110000000000010001100010001
1000100100100000001000100010001100010001
1000100100100000001000100000000000010001
1000100100111111111000111111111111110001
1000100100000000000000000000000000010001
1000100100000000000000000000000000010001
1000100111111111111111111111111110010001
1000000000000000000111000000000000010001
1000000000000000000000000000000000010B01
1111111111111111111111111111111111111111
